xxxx   xxxx
x    x    x
x xxxx xx x
x  x x x  x
xx       xx
xx xx xx xx
x         x
x x xxx x x
x         x
xxxxxxxxxxx